NO sprites/emaillet_so_long/lose.xpm
SO sprites/emaillet_so_long/win.xpm
WE sprites/emaillet_so_long/menu.xpm
EA sprites/emaillet_so_long/enemy.xpm
DO sprites/door.xpm

F ,220,100,0
C 225,30,0

111111
10D0W1
111111
