NO sprites/floor.xpm
SO sprites/floor.xpm
WE sprites/floor.xpm
EA sprites/floor.xpm
DO sprites/door.xpm

F 255,0,0
C 255,0,0

 1111
1E0D01
 1111
