NO sprites/bob_leponge.xpm
SO sprites/saucisse.xpm
WE sprites/illuminati.xpm
EA sprites/sasha_patate.xpm
DO sprites/sad_guy.xpm

F 0,0,0
C 255,0,0

     1111111
    100010001
    100000001
    100010001
     11111D11
        10001
        10001
        10001
        11D11    1111111 
        10001   100010001
        10001   1000D0001
        10001   100010001
 111111111D1111111D111111
1000100010001000100010001
1000D000D000D000D000D0001
1000100010001000100010001
 11111D11111111111111111 
    1000100010001
    1000D000D0001
    1000100010001
     11111D11111 
        10001
        10001
        10001
     11111D11111 
    1000100010001
    1000D0N0D0001
    1000100010001
     11111111111 
