NO sprites/emaillet_so_long/heart.xpm
SO sprites/emaillet_so_long/potion.xpm
WE sprites/emaillet_so_long/saturn.xpm
EA sprites/emaillet_so_long/red_chest.xpm
DO sprites/emaillet_so_long/finish.xpm

F 0,100,0
C 0,30,0

    11111111
  1100000001
  1001010001
 1001111111
100000001
10001011
1000001
10E001
100001
100001
100001
101001
1001001
100D001
1000D01
 1000011
  1000001
   111111
