NO sprites/wall1.xpm
SO sprites/wall2.xpm
WE sprites/wall3.xpm
EA sprites/wall4.xpm

F 0,100,100
C 0,30,0

1111D111
10000001
1111N111
11111111
