C 225,30,0
NO sprites/wall1.xpm

SO sprites/wall2.xpm


WE                     sprites/wall3.xpm




DO sprites/floor.xpm
F 220,100,0
EA sprites/wall4.xpm


                          
       
               
     
11111         11111
10001         10001
10001         10001
10001         10001
11D1111111111111D11
1000000000000000001
1000000000000000001
1000110000000110001
1000110000000110001
1000000000000000001
1000000000000000001
1000000000000000001
100000000N000000001
1000000000000000001
1000001111111000001
1000001111111000001
1000001110111000001
1000001110111000001
1000001110111000001
1111111111111111111
