NO sprites/wall1.xpm
SO sprites/wall2.xpm
WE sprites/wall3.xpm
EA sprites/wall4.xpm
DO sprites/door.xpm

C 10,10,70
F 42,42,42

1111111111111111111111111111111111111111111111111111111111111111111111111111111111111111111111111111111111111111111111111111111111111111111111111111111
1000W0000000000000000000000000000000000000000000000000000000000000000000000000000000000000000000000000000000DDDDDDDDDDDDDDDDDDDDDDDDDDDDDDDDDDDDDDDDDD1
100D001111111111111111111111111111111111111111111111111111111111111111111111111111111111111111111111111111111111111111111111111111111111111111111111111
10D00000000001
10000000DD0001
100D0D00000001
11111111111111