11111111111111111
100000N0000000001
11111111111111111
