NO ../sprites/wall.xpm
SO ../sprites/wall.xpm
WE ../sprites/wall.xpm
EA ../sprites/wall.xpm

F 220,100,0
C 225,30,0

1111111111111111111
1000N00000000000001
1111111111111111111
