NO sprites/wall1.xpm
SO sprites/wall2.xpm
WE sprites/wall3.xpm
EA sprites/wall4.xpm

F 0,100,100
C 0,30,0

    11111111
  11W0000001
  1001010001
 1001111111
100000001
10001011
1000001
100001
100001
100001
100001
101001
1001001
1000001
1000001
 1000011
  1000001
   111111
