1111111111111111111
1000N00000000000001
1111111111111111111
