SO sprites/wall2.xpm
NO sprites/wall1.xpm
WE sprites/wall3.xpm

DO sprites/floor.xpm
F 220,100,0
C 225,30,0
EA sprites/wall4.xpm
11111
10001
1111111111111111111111111111111111
1000000000000000000000000000000001
10000000000000000000000000000000W1
1000000000000000000000000000000001
1111111111111111111111111111111111
10001
11111
