NO sprites/wall.xpm
SO sprites/wall.xpm
WE sprites/wall.xpm
EA sprites/wall.xpm
DO sprites/floor.xpm

F 164,107,38
C 128,128,128

1111111111111111111111111111111111111111111
1000000000000000000000000000000000000000001
1011111111101111111110111111111111101111101
1011111111101111111110111111111111101111101
1011000001001001001000000000000000001001101
1011001111001001001111111001001111111001101
1011000001001001000000001001001000001001101
1011001111001001111001111001111111001001101
1011000001000001000000000001000000000001101
1011111001001001111001111001111111001001101
1000001000001000001001000001000000001001101
1011001001111111001111001111001111001001101
1011001001000001000000001000001000001000001
1011001111001111111D11001001111111111111101
1011000001000001001000N00000000001000001101
1011001001001001001001111001111111111001101
1011001001001001000001000001000001000001101
1011001111111001111001001111111001111001101
1011000000000001000001000000001001000001101
1011111111111001001111111001111001001111101
1011001000001001001000001001001001000001101
1011001001111001001111001001001001001001101
1011000000000000000000001000000000001001101
1011111111101111111111111111111111111011101
1011111111101111111111111111111111111011101
1000000000000000000000000000000000000000001
1111111111111111111111111111111111111111111
