NO sprites/wall1.xpm
SO sprites/wall2.xpm
WE sprites/wall3.xpm
EA sprites/wall4.xpm

F 220,100,0
C 225,30,0

111111
10S01
10N01
111111
