NO sprites/wall1.xpm
SO sprites/wall2.xpm
WE sprites/wall3.xpm
EA sprites/wall4.xpm

F 0,100,100
C 0,30,0

11111111111111111
1000100000D000001
10E0D000001000001
1000100000D000001
11111111111111111
