NO sprites/wall.xpm
SO sprites/wall.xpm
WE sprites/wall.xpm
EA sprites/wall.xpm

F 220,100,0
C 225,30,0

111111111111111111
100000000N00000001
111111111111111111
100000000000000001
111111111111111111
