NO sprites/wall1.xpm
SO sprites/wall2.xpm
WE sprites/wall3.xpm
EA sprites/wall4.xpm
DO sprites/door.xpm

C 10,10,70
F 200,200,200

1111111111111111111111111111111111111111111111111111111111111111111111111111111111111111
1000W0000000000000000000000000000000000000000DDDDDDDDDDDDDDDDDDDDDDDDDDDDDDDDDDDDDDDDDD1
100000000000000000000000000000000000000000000DDDDDDDDDDDDDDDDDDDDDDDDDDDDDDDDDDDDDDDDDD1
100000000000000000000000000000000000000000000DDDDDDDDDDDDDDDDDDDDDDDDDDDDDDDDDDDDDDDDDD1
100000000000000000000000000000000000000000000DDDDDDDDDDDDDDDDDDDDDDDDDDDDDDDDDDDDDDDDDD1
100000000000000000000000000000000000000000000DDDDDDDDDDDDDDDDDDDDDDDDDDDDDDDDDDDDDDDDDD1
100000000000000000000000000000000000000000000DDDDDDDDDDDDDDDDDDDDDDDDDDDDDDDDDDDDDDDDDD1
100000000000000000000000000000000000000000000DDDDDDDDDDDDDDDDDDDDDDDDDDDDDDDDDDDDDDDDDD1
100000000000000000000000000000000000000000000DDDDDDDDDDDDDDDDDDDDDDDDDDDDDDDDDDDDDDDDDD1
100000000000000000000000000000000000000000000DDDDDDDDDDDDDDDDDDDDDDDDDDDDDDDDDDDDDDDDDD1
100000000000000000000000000000000000000000000DDDDDDDDDDDDDDDDDDDDDDDDDDDDDDDDDDDDDDDDDD1
100000000000000000000000000000000000000000000DDDDDDDDDDDDDDDDDDDDDDDDDDDDDDDDDDDDDDDDDD1
100000000000000000000000000000000000000000000DDDDDDDDDDDDDDDDDDDDDDDDDDDDDDDDDDDDDDDDDD1
100000000000000000000000000000000000000000000DDDDDDDDDDDDDDDDDDDDDDDDDDDDDDDDDDDDDDDDDD1
100000000000000000000000000000000000000000000DDDDDDDDDDDDDDDDDDDDDDDDDDDDDDDDDDDDDDDDDD1
100000000000000000000000000000000000000000000DDDDDDDDDDDDDDDDDDDDDDDDDDDDDDDDDDDDDDDDDD1
100000000000000000000000000000000000000000000DDDDDDDDDDDDDDDDDDDDDDDDDDDDDDDDDDDDDDDDDD1
100000000000000000000000000000000000000000000DDDDDDDDDDDDDDDDDDDDDDDDDDDDDDDDDDDDDDDDDD1
100000000000000000000000000000000000000000000DDDDDDDDDDDDDDDDDDDDDDDDDDDDDDDDDDDDDDDDDD1
111111111111111111111111111111111111111111111111111111111111111111111111111111111111111
