NO sprites/wall1.xpm
SO sprites/wall2.xpm
WE sprites/wall3.xpm
EA sprites/wall4.xpm
DO sprites/door.xpm

C 20,10,150
F 130,130,130

11111111111111111111111
10000000000000000000001
10000000000000000000001
10000000000000000000001
10000000000000000000001
10000000000000000000001
10000000000000000000001
10000000000000000000001
10000000000000000000001
11111111111D11111111111
          1N1
11111111111D11111111111
10000000000000000000001
10000000000000000000001
10000000000000000000001
10000000000000000000001
10000000000000000000001
10000000000000000000001
10000000000000000000001
10000000000000000000001
11111111111111111111111
