NO sprites/wall.xpm
SO sprites/wall.xpm
WE sprites/wall.xpm
EA sprites/wall.xpm
DO sprites/door.xpm

F 164,107,38
C 128,128,128

1111111111111111111111111111111111111111111
1D000000000000000000000000000000000000000D1
10111111111D111111111D1111111111111D1111101
1011111111101111111110111111111111101111101
1011000001001001001000000000000000001001101
1011001111001001001111111001001111111001101
101100000100100100D000001001001000001001101
10110011110010011110011110011111D1001001101
101100000100D001000000000001000000000001101
1011111001001001111001111001111111001001101
10D000100D00100000100100000100000D001001101
1011001001111111001111001111001111001001101
1011001001000001000000001000001000001000D01
1011001111001111111D11001001111111111111101
101100000100D001001000N00000000001000001101
1011001001001001001001111001111111111001101
101100100100100100000100000100D001000001101
1011001111111001111001001111111001111001101
1011000000000001000001000000001001000001101
1011111111111001001111111001111001001111101
101100100D00100100100D001001001001000001101
1011001001111001001111001001001001001001101
1011000000000000000000001000000000001001101
1011111111101111111111111111111111111011101
10111111111D1111111111111111111111111D11101
1D000000000000000000000000000000000000000D1
1111111111111111111111111111111111111111111
