
NO sprites/zelda_wall.xpm
SO sprites/zelda_wall.xpm
WE sprites/zelda_wall.xpm
EA sprites/zelda_wall.xpm
DO sprites/zelda_door.xpm
F 0,80,130
C 0,40,70

     1111111
    100010001
    100000001
    100010001
     11111D11    1111111
        10001   100010001
        10001   1000D0001
        10001   100010001
 111111111D1111111D11111
100010001000100010001
1000D000D000D000D0001
100010001000100010001
 11111D1111111111111
    1000100010001
    1000D000D0001
    1000100010001
     11111D11111 
        10001
        10001
        10001
     11111D11111 
    1000100010001
    1000D0N0D0001
    1000100010001
     11111111111 
