NO sprites/wall1.xpm
SO sprites/wall2.xpm
WE sprites/wall3.xp
EA sprites/wall4.xpm
DO sprites/zelda_door.xpm

C 0,10,0
F 0, 50, 0

11111111111111
10000000000001
100001D1000001
10000000000001
10000D1D000001
10000000000001
10000DDD000001
10000000000001
100D0000010001
1000D0D0100001
100000D0000001
100000N0000001
11111111111111
