NO sprites/wall1.xpm
SO sprites/wall2.xpm
WE sprites/wall3.xpm
EA sprites/wall4.xpm

DO sprites/door.xpm
F 220,100,0
F 225,30,0

11111
10001
10N01
10001
11111
