NO sprites/wall1.xpm
SO sprites/wall2.xpm
WE sprites/wall3.xpm
EA sprites/wall4.xpm
DO sprites/door.xpm

F 220,100,0
C 225,30,0

111111111
10000000101
1E000000D01
10000000101
1111111111
